GGGGGGGGGGGGGGGGGGGGG
GGGGGGGGGGGGGGGGGGGGG
GGGGGGGGGKKKGGGGGGGGG
GGGGGGGGGKKKGGGGGGGGG
GGGGGW FFFFFFF WGGGGG
GGGGG  E E E E  GGGGG
GGGGGFF FFF FFFFGGGGG
GGGGGJ         JGGGGG
GGGKKFFFF FFF FFKKGGG
GGGKK  E E E E  KKGGG
GGGKKFF FFF FFFFKKGGG
GGGGG  E E E E  GGGGG
GGGGGFFFF FFF FFGGGGG
GGGGG  E E E E  GGGGG
GGGGG  FFFFFFF  GGGGG
GGGGGGGGG   GGGGGGGGG
GGGGGGGGG  ZGGGGGGGGG
GGGGGGGGGGGGGGGGGGGGG
GGGGGGGGGGGGGGGGGGGGG