GGGGGGGGGGGGGGGGGGGG
GY       Q        YG
G FFFFFFFFFFFFFFFF G
G FY    OOOO    YF G
G F FFFFF  FFFFF F G
GQF FY   KK   YF FQG
G F F FFFFFFFF F F G
G F FYF      FYF F G
G FKF F  BB  F FKF G
G FKF F  BB  F FKFLG
GZ  F    TT    F  LG
G   F          F  LG
G FKF F  BB  F FKFLG
G FKF F  BB  F FKF G
GQF FYF      FYF FQG
G F FFFFF  FFFFF F G
G FY    OOOO    YF G
G FFFFFFFFFFFFFFFF G
GY       Q        YG
GGGGGGGGGGGGGGGGGGGG