GGGGGGGGGGGGGGGGG
GZ             VG
G FOFOFOFOFOFOF G
G OOFOFOFOFOFOF G
G FFFOFOFOFOFOF G
G OOOOFOFOFOFOF G
G FFFFFOFOFOFOF G
G OOOOOOFOFOFOF G
G FFFFFFFOFOFOF G
G OOOOOOOOFOFOF G
G FFFFFFFFFOFOF G
G OOOOOOOOOOFOF G
G FFFFFFFFFFFOF G
G OOOOOOOOOOOJF G
G FFFFFFFFFFFFF G
GV              G
GGGGGGGGGGGGGGGGG