GGGGGGGGGGGGGGGGGGG
GMMMMMMMMGMMMMMMMMG
GMGGMGGGMGMGGGMGGMG
GMGGMGGGMGMGGGMGGMG
GMMMMMMMMMMMMMMMMMG
GMGGMGMGGGGGMGMGGMG
GMMMMGMMMGMMMGMMMMG
GGGGMGGGMGMGGGMGGGG
GGGGMG       GMGGGG
GGGGMG GGQGG GMGGGG
GMMMMM GVVVG MMMMMG
GGGGMG GGGGG GMGGGG
GGGGMG   Z   GMGGGG
GGGGMG GGGGG GMGGGG
GMMMMM   G   MMMMMG
GMGGMGGG G GGGMGGMG
GMMGMMMM   MMMMGMMG
GGMGMGMGGGGGMGMGMGG
GMMMMGMMMGMMMGMMMMG
GMGGGGGGMGMGGGGGGMG
GMMMMMMMMMMMMMMMMMG
GGGGGGGGGGGGGGGGGGG